//MAP CONVERTED BY dmm2tgm.py THIS HEADER COMMENT PREVENTS RECONVERSION, DO NOT REMOVE
"aO" = (
/obj/structure/disposalpipe/segment{
	dir = 6
	},
/turf/open/floor/plating,
/area/tdome/arena)
"bP" = (
/obj/machinery/light/dim,
/obj/effect/decal/cleanable/dirt/dust,
/obj/machinery/atmospherics/pipe/smart/simple/supply/visible/layer4{
	dir = 8
	},
/obj/machinery/atmospherics/pipe/smart/simple/scrubbers/visible/layer2{
	dir = 4
	},
/obj/structure/cable,
/turf/open/floor/plating,
/area/tdome/arena)
"cz" = (
/obj/effect/decal/cleanable/blood/gibs/bubblegum,
/turf/open/floor/plating,
/area/tdome/arena)
"cC" = (
/obj/machinery/door/airlock/maintenance_hatch,
/obj/structure/disposalpipe/segment{
	dir = 4
	},
/obj/machinery/door/firedoor/border_only{
	dir = 4
	},
/obj/machinery/door/firedoor/border_only{
	dir = 8
	},
/turf/open/floor/plating,
/area/tdome/arena)
"dF" = (
/obj/structure/disposalpipe/segment{
	dir = 9
	},
/obj/machinery/atmospherics/pipe/smart/simple/supply/visible/layer4{
	dir = 8
	},
/obj/machinery/atmospherics/pipe/smart/simple/scrubbers/visible/layer2{
	dir = 4
	},
/obj/effect/decal/cleanable/blood/footprints{
	dir = 4
	},
/obj/structure/cable,
/turf/open/floor/plating,
/area/tdome/arena)
"ex" = (
/obj/machinery/atmospherics/pipe/smart/simple/supply/visible/layer4{
	dir = 8
	},
/obj/machinery/atmospherics/pipe/smart/simple/scrubbers/visible/layer2{
	dir = 4
	},
/obj/structure/cable,
/turf/open/floor/plating,
/area/tdome/arena)
"eA" = (
/obj/structure/closet/crate/freezer,
/obj/effect/turf_decal/tile/blue/anticorner{
	dir = 4
	},
/turf/open/floor/plating,
/area/tdome/arena)
"fq" = (
/obj/machinery/door/airlock/maintenance_hatch,
/obj/structure/disposalpipe/segment{
	dir = 4
	},
/obj/machinery/atmospherics/pipe/smart/simple/supply/visible/layer4{
	dir = 8
	},
/obj/machinery/atmospherics/pipe/smart/simple/scrubbers/visible/layer2{
	dir = 4
	},
/obj/effect/decal/cleanable/blood/footprints{
	dir = 4
	},
/obj/structure/cable,
/obj/machinery/door/firedoor/border_only{
	dir = 4
	},
/obj/machinery/door/firedoor/border_only{
	dir = 8
	},
/turf/open/floor/plating,
/area/tdome/arena)
"fU" = (
/obj/structure/disposalpipe/segment{
	dir = 10
	},
/obj/machinery/atmospherics/pipe/smart/manifold/scrubbers/visible/layer2{
	dir = 8
	},
/obj/machinery/atmospherics/pipe/smart/manifold/supply/visible/layer4{
	dir = 8
	},
/obj/structure/cable,
/turf/open/floor/plating,
/area/tdome/arena)
"fX" = (
/obj/item/trash/candy,
/obj/effect/decal/cleanable/dirt/dust,
/turf/open/floor/plating,
/area/tdome/arena)
"go" = (
/obj/machinery/smartfridge/organ,
/obj/effect/turf_decal/tile/blue/half{
	dir = 1
	},
/turf/open/floor/plating,
/area/tdome/arena)
"gL" = (
/obj/machinery/atmospherics/pipe/smart/simple/supply/visible/layer4{
	dir = 8
	},
/obj/machinery/atmospherics/pipe/smart/simple/scrubbers/visible/layer2{
	dir = 4
	},
/obj/effect/decal/cleanable/blood/footprints{
	dir = 4
	},
/obj/structure/cable,
/obj/machinery/door/airlock/maintenance_hatch,
/obj/machinery/door/firedoor/border_only{
	dir = 4
	},
/obj/machinery/door/firedoor/border_only{
	dir = 8
	},
/turf/open/floor/plating,
/area/tdome/arena)
"hp" = (
/obj/structure/cable,
/obj/machinery/atmospherics/pipe/smart/simple/supply/visible/layer4{
	dir = 8
	},
/obj/machinery/atmospherics/pipe/smart/simple/scrubbers/visible/layer2{
	dir = 4
	},
/obj/machinery/door/airlock/maintenance_hatch,
/obj/machinery/door/firedoor/border_only{
	dir = 4
	},
/obj/machinery/door/firedoor/border_only{
	dir = 8
	},
/turf/open/floor/plating,
/area/tdome/arena)
"hB" = (
/turf/closed/wall,
/area/tdome/arena)
"hO" = (
/obj/structure/disposalpipe/segment,
/obj/effect/decal/cleanable/dirt/dust,
/obj/machinery/atmospherics/pipe/smart/simple/supply/visible/layer4,
/obj/machinery/atmospherics/pipe/smart/simple/scrubbers/visible/layer2,
/obj/structure/cable,
/turf/open/floor/plating,
/area/tdome/arena)
"iP" = (
/obj/structure/disposalpipe/segment{
	dir = 6
	},
/obj/machinery/atmospherics/pipe/smart/manifold/scrubbers/visible/layer2{
	dir = 4
	},
/obj/machinery/atmospherics/pipe/smart/manifold/supply/visible/layer4{
	dir = 4
	},
/obj/structure/cable,
/turf/open/floor/plating,
/area/tdome/arena)
"iR" = (
/obj/structure/disposalpipe/segment{
	dir = 4
	},
/obj/machinery/door/airlock/maintenance_hatch,
/obj/machinery/door/firedoor/border_only{
	dir = 4
	},
/obj/machinery/door/firedoor/border_only{
	dir = 8
	},
/turf/open/floor/plating,
/area/tdome/arena)
"jB" = (
/obj/effect/decal/cleanable/dirt/dust,
/obj/machinery/atmospherics/pipe/smart/simple/supply/visible/layer4{
	dir = 8
	},
/obj/machinery/atmospherics/pipe/smart/simple/scrubbers/visible/layer2{
	dir = 4
	},
/obj/machinery/door/airlock/maintenance_hatch,
/obj/machinery/door/firedoor/border_only{
	dir = 4
	},
/obj/machinery/door/firedoor/border_only{
	dir = 8
	},
/turf/open/floor/plating,
/area/tdome/arena)
"kD" = (
/obj/structure/disposalpipe/segment{
	dir = 4
	},
/obj/machinery/atmospherics/pipe/smart/manifold/supply/visible/layer4{
	dir = 1
	},
/obj/machinery/atmospherics/pipe/smart/manifold/scrubbers/visible/layer2{
	dir = 1
	},
/obj/structure/cable,
/turf/open/floor/plating,
/area/tdome/arena)
"kS" = (
/obj/structure/disposalpipe/trunk,
/obj/machinery/disposal/delivery_chute,
/turf/open/floor/plating,
/area/tdome/arena)
"lB" = (
/obj/structure/table/optable,
/obj/machinery/light/dim{
	dir = 1
	},
/obj/effect/mob_spawn/human/clown/corpse,
/obj/effect/turf_decal/tile/blue/half{
	dir = 1
	},
/turf/open/floor/plating,
/area/tdome/arena)
"lJ" = (
/obj/machinery/door/airlock/maintenance_hatch,
/obj/structure/disposalpipe/segment{
	dir = 4
	},
/obj/effect/decal/cleanable/dirt/dust,
/obj/machinery/atmospherics/pipe/smart/simple/supply/visible/layer4{
	dir = 8
	},
/obj/machinery/atmospherics/pipe/smart/simple/scrubbers/visible/layer2{
	dir = 4
	},
/obj/machinery/door/firedoor/border_only{
	dir = 4
	},
/obj/machinery/door/firedoor/border_only{
	dir = 8
	},
/turf/open/floor/plating,
/area/tdome/arena)
"nR" = (
/obj/structure/disposalpipe/segment{
	dir = 9
	},
/obj/effect/decal/cleanable/dirt/dust,
/obj/machinery/atmospherics/pipe/smart/simple/supply/visible/layer4{
	dir = 8
	},
/obj/machinery/atmospherics/pipe/smart/simple/scrubbers/visible/layer2{
	dir = 4
	},
/obj/structure/cable,
/turf/open/floor/plating,
/area/tdome/arena)
"nW" = (
/obj/machinery/light/floor,
/obj/effect/decal/cleanable/crayon,
/turf/open/floor/plating,
/area/tdome/arena)
"od" = (
/obj/structure/disposalpipe/junction/yjunction{
	dir = 1
	},
/obj/effect/decal/cleanable/dirt/dust,
/obj/machinery/atmospherics/pipe/smart/manifold/supply/visible/layer4,
/obj/machinery/atmospherics/pipe/smart/manifold/scrubbers/visible/layer2,
/turf/open/floor/plating,
/area/tdome/arena)
"ot" = (
/obj/machinery/light/small{
	dir = 4
	},
/obj/machinery/atmospherics/pipe/smart/simple/supply/visible/layer4,
/obj/machinery/atmospherics/pipe/smart/simple/scrubbers/visible/layer2,
/obj/structure/cable,
/turf/open/floor/plating,
/area/tdome/arena)
"oJ" = (
/obj/structure/disposalpipe/segment{
	dir = 4
	},
/obj/machinery/atmospherics/pipe/smart/manifold/supply/visible/layer4{
	dir = 1
	},
/obj/machinery/atmospherics/pipe/smart/manifold/scrubbers/visible/layer2{
	dir = 1
	},
/obj/effect/decal/cleanable/blood/footprints{
	dir = 4
	},
/obj/structure/cable,
/turf/open/floor/plating,
/area/tdome/arena)
"oW" = (
/obj/structure/disposalpipe/trunk{
	dir = 1
	},
/obj/machinery/disposal/delivery_chute{
	dir = 1
	},
/turf/open/floor/plating,
/area/tdome/arena)
"sp" = (
/obj/machinery/light/small{
	dir = 8
	},
/obj/machinery/atmospherics/pipe/smart/simple/supply/visible/layer4,
/obj/machinery/atmospherics/pipe/smart/simple/scrubbers/visible/layer2,
/obj/structure/cable,
/turf/open/floor/plating,
/area/tdome/arena)
"sP" = (
/obj/machinery/light/dim,
/obj/effect/decal/cleanable/dirt/dust,
/obj/machinery/atmospherics/pipe/smart/simple/supply/visible/layer4{
	dir = 8
	},
/obj/machinery/atmospherics/pipe/smart/simple/scrubbers/visible/layer2{
	dir = 4
	},
/turf/open/floor/plating,
/area/tdome/arena)
"tR" = (
/obj/structure/disposalpipe/segment{
	dir = 4
	},
/obj/machinery/light/small,
/obj/effect/decal/cleanable/dirt/dust,
/obj/machinery/atmospherics/pipe/smart/simple/supply/visible/layer4{
	dir = 8
	},
/obj/machinery/atmospherics/pipe/smart/simple/scrubbers/visible/layer2{
	dir = 4
	},
/turf/open/floor/plating,
/area/tdome/arena)
"vk" = (
/obj/machinery/door/airlock/maintenance_hatch,
/obj/structure/disposalpipe/segment,
/obj/effect/decal/cleanable/dirt/dust,
/obj/machinery/atmospherics/pipe/smart/simple/supply/visible/layer4,
/obj/machinery/atmospherics/pipe/smart/simple/scrubbers/visible/layer2,
/obj/structure/cable,
/obj/machinery/door/firedoor/border_only,
/obj/machinery/door/firedoor/border_only{
	dir = 1
	},
/turf/open/floor/plating,
/area/tdome/arena)
"vA" = (
/obj/machinery/light/small,
/obj/machinery/atmospherics/pipe/smart/simple/supply/visible/layer4{
	dir = 8
	},
/obj/machinery/atmospherics/pipe/smart/simple/scrubbers/visible/layer2{
	dir = 4
	},
/turf/open/floor/plating,
/area/tdome/arena)
"xT" = (
/obj/machinery/smartfridge{
	name = "smartbloodbank"
	},
/obj/effect/turf_decal/tile/blue/half{
	dir = 1
	},
/turf/open/floor/plating,
/area/tdome/arena)
"yr" = (
/obj/machinery/door/airlock/maintenance_hatch,
/obj/structure/disposalpipe/segment{
	dir = 4
	},
/obj/effect/decal/cleanable/dirt/dust,
/obj/machinery/atmospherics/pipe/smart/simple/supply/visible/layer4{
	dir = 8
	},
/obj/machinery/atmospherics/pipe/smart/simple/scrubbers/visible/layer2{
	dir = 4
	},
/obj/structure/cable,
/obj/machinery/door/firedoor/border_only{
	dir = 4
	},
/obj/machinery/door/firedoor/border_only{
	dir = 8
	},
/turf/open/floor/plating,
/area/tdome/arena)
"zx" = (
/obj/structure/disposalpipe/segment{
	dir = 4
	},
/obj/effect/decal/cleanable/dirt/dust,
/obj/machinery/atmospherics/pipe/smart/simple/supply/visible/layer4{
	dir = 8
	},
/obj/machinery/atmospherics/pipe/smart/simple/scrubbers/visible/layer2{
	dir = 4
	},
/turf/open/floor/plating,
/area/tdome/arena)
"BI" = (
/obj/machinery/door/airlock/maintenance_hatch,
/obj/structure/disposalpipe/segment{
	dir = 4
	},
/obj/machinery/atmospherics/pipe/smart/simple/supply/visible/layer4{
	dir = 8
	},
/obj/machinery/atmospherics/pipe/smart/simple/scrubbers/visible/layer2{
	dir = 4
	},
/obj/machinery/door/firedoor/border_only{
	dir = 4
	},
/obj/machinery/door/firedoor/border_only{
	dir = 8
	},
/turf/open/floor/plating,
/area/tdome/arena)
"BQ" = (
/obj/machinery/door/airlock/maintenance_hatch,
/obj/machinery/atmospherics/pipe/smart/simple/supply/visible/layer4{
	dir = 8
	},
/obj/machinery/atmospherics/pipe/smart/simple/scrubbers/visible/layer2{
	dir = 4
	},
/obj/machinery/door/firedoor/border_only{
	dir = 4
	},
/obj/machinery/door/firedoor/border_only{
	dir = 8
	},
/turf/open/floor/plating,
/area/tdome/arena)
"Cz" = (
/obj/machinery/light/dim{
	dir = 1
	},
/turf/open/floor/plating,
/area/tdome/arena)
"Dl" = (
/obj/structure/table,
/obj/effect/turf_decal/tile/blue/half{
	dir = 1
	},
/turf/open/floor/plating,
/area/tdome/arena)
"Dp" = (
/obj/machinery/door/airlock/maintenance_hatch,
/obj/structure/disposalpipe/segment,
/obj/effect/decal/cleanable/dirt/dust,
/obj/machinery/atmospherics/pipe/smart/simple/supply/visible/layer4,
/obj/machinery/atmospherics/pipe/smart/simple/scrubbers/visible/layer2,
/obj/machinery/door/firedoor/border_only,
/obj/machinery/door/firedoor/border_only{
	dir = 1
	},
/turf/open/floor/plating,
/area/tdome/arena)
"Du" = (
/obj/structure/disposalpipe/segment{
	dir = 5
	},
/obj/machinery/atmospherics/pipe/smart/simple/supply/visible/layer4{
	dir = 8
	},
/obj/machinery/atmospherics/pipe/smart/simple/scrubbers/visible/layer2{
	dir = 4
	},
/turf/open/floor/plating,
/area/tdome/arena)
"Dx" = (
/obj/effect/decal/cleanable/dirt/dust,
/obj/machinery/atmospherics/pipe/smart/simple/supply/visible/layer4{
	dir = 8
	},
/obj/machinery/atmospherics/pipe/smart/simple/scrubbers/visible/layer2{
	dir = 4
	},
/obj/structure/cable,
/obj/machinery/door/airlock/maintenance_hatch,
/obj/machinery/door/firedoor/border_only{
	dir = 4
	},
/obj/machinery/door/firedoor/border_only{
	dir = 8
	},
/turf/open/floor/plating,
/area/tdome/arena)
"DB" = (
/obj/structure/closet/crate/freezer,
/obj/effect/turf_decal/tile/blue/anticorner{
	dir = 1
	},
/turf/open/floor/plating,
/area/tdome/arena)
"DE" = (
/obj/machinery/door/airlock/maintenance_hatch,
/obj/effect/decal/cleanable/dirt/dust,
/obj/machinery/door/firedoor/border_only,
/obj/machinery/door/firedoor/border_only{
	dir = 1
	},
/turf/open/floor/plating,
/area/tdome/arena)
"EK" = (
/obj/structure/disposalpipe/trunk,
/obj/effect/decal/cleanable/dirt/dust,
/obj/machinery/disposal/delivery_chute,
/turf/open/floor/plating,
/area/tdome/arena)
"Gq" = (
/obj/effect/decal/cleanable/blood/splatter,
/turf/open/floor/plating,
/area/tdome/arena)
"GF" = (
/obj/machinery/atmospherics/pipe/smart/simple/supply/visible/layer4{
	dir = 8
	},
/obj/machinery/atmospherics/pipe/smart/simple/scrubbers/visible/layer2{
	dir = 4
	},
/obj/machinery/door/airlock/maintenance_hatch,
/obj/machinery/door/firedoor/border_only{
	dir = 4
	},
/obj/machinery/door/firedoor/border_only{
	dir = 8
	},
/turf/open/floor/plating,
/area/tdome/arena)
"Kc" = (
/obj/machinery/light/small,
/obj/machinery/atmospherics/pipe/smart/simple/supply/visible/layer4{
	dir = 8
	},
/obj/machinery/atmospherics/pipe/smart/simple/scrubbers/visible/layer2{
	dir = 4
	},
/obj/structure/cable,
/turf/open/floor/plating,
/area/tdome/arena)
"Qw" = (
/obj/effect/decal/cleanable/dirt/dust,
/turf/open/floor/plating,
/area/tdome/arena)
"QK" = (
/turf/open/floor/plating,
/area/tdome/arena)
"QP" = (
/obj/structure/disposalpipe/segment{
	dir = 10
	},
/obj/effect/decal/cleanable/blood/gibs/core,
/turf/open/floor/plating,
/area/tdome/arena)
"Rw" = (
/obj/structure/disposalpipe/segment{
	dir = 5
	},
/obj/effect/decal/cleanable/dirt/dust,
/obj/machinery/atmospherics/pipe/smart/simple/supply/visible/layer4{
	dir = 8
	},
/obj/machinery/atmospherics/pipe/smart/simple/scrubbers/visible/layer2{
	dir = 4
	},
/turf/open/floor/plating,
/area/tdome/arena)
"Sn" = (
/obj/machinery/atmospherics/pipe/smart/simple/supply/visible/layer4{
	dir = 8
	},
/obj/machinery/atmospherics/pipe/smart/simple/scrubbers/visible/layer2{
	dir = 4
	},
/obj/effect/decal/cleanable/blood/footprints{
	dir = 4
	},
/obj/structure/cable,
/turf/open/floor/plating,
/area/tdome/arena)
"Sz" = (
/obj/machinery/door/airlock/maintenance_hatch,
/obj/machinery/atmospherics/pipe/smart/simple/supply/visible/layer4{
	dir = 8
	},
/obj/machinery/atmospherics/pipe/smart/simple/scrubbers/visible/layer2{
	dir = 4
	},
/obj/structure/cable,
/obj/machinery/door/firedoor/border_only{
	dir = 4
	},
/obj/machinery/door/firedoor/border_only{
	dir = 8
	},
/turf/open/floor/plating,
/area/tdome/arena)
"Um" = (
/obj/structure/disposalpipe/junction/yjunction{
	dir = 1
	},
/obj/effect/decal/cleanable/dirt/dust,
/obj/machinery/atmospherics/pipe/smart/manifold/supply/visible/layer4,
/obj/machinery/atmospherics/pipe/smart/manifold/scrubbers/visible/layer2,
/obj/structure/cable,
/turf/open/floor/plating,
/area/tdome/arena)
"Va" = (
/obj/item/trash/cheesie,
/obj/effect/decal/cleanable/dirt/dust,
/turf/open/floor/plating,
/area/tdome/arena)
"VH" = (
/obj/structure/disposalpipe/segment{
	dir = 4
	},
/obj/machinery/atmospherics/pipe/smart/simple/supply/visible/layer4{
	dir = 8
	},
/obj/machinery/atmospherics/pipe/smart/simple/scrubbers/visible/layer2{
	dir = 4
	},
/obj/effect/decal/cleanable/blood/footprints{
	dir = 4
	},
/obj/structure/cable,
/turf/open/floor/plating,
/area/tdome/arena)
"WK" = (
/obj/machinery/door/airlock/maintenance_hatch,
/obj/effect/decal/cleanable/blood/footprints,
/obj/effect/decal/cleanable/blood/footprints{
	dir = 1
	},
/obj/machinery/door/firedoor/border_only,
/obj/machinery/door/firedoor/border_only{
	dir = 1
	},
/turf/open/floor/plating,
/area/tdome/arena)
"Xf" = (
/obj/machinery/door/airlock/maintenance_hatch,
/obj/machinery/atmospherics/pipe/smart/simple/supply/visible/layer4,
/obj/machinery/atmospherics/pipe/smart/simple/scrubbers/visible/layer2,
/obj/structure/cable,
/obj/machinery/door/firedoor/border_only,
/obj/machinery/door/firedoor/border_only{
	dir = 1
	},
/turf/open/floor/plating,
/area/tdome/arena)
"XA" = (
/obj/structure/grille,
/turf/open/floor/plating,
/area/tdome/arena)
"Yq" = (
/obj/effect/decal/cleanable/blood/gibs,
/obj/effect/decal/cleanable/blood/footprints{
	dir = 1
	},
/turf/open/floor/plating,
/area/tdome/arena)
"YM" = (
/obj/machinery/atmospherics/pipe/smart/simple/supply/visible/layer4{
	dir = 8
	},
/obj/machinery/atmospherics/pipe/smart/simple/scrubbers/visible/layer2{
	dir = 4
	},
/turf/open/floor/plating,
/area/tdome/arena)
"YP" = (
/obj/structure/disposalpipe/segment,
/obj/effect/decal/cleanable/dirt/dust,
/obj/machinery/atmospherics/pipe/smart/simple/supply/visible/layer4,
/obj/machinery/atmospherics/pipe/smart/simple/scrubbers/visible/layer2,
/turf/open/floor/plating,
/area/tdome/arena)
"ZB" = (
/obj/effect/decal/cleanable/dirt/dust,
/turf/closed/wall,
/area/tdome/arena)
"ZD" = (
/obj/structure/disposalpipe/segment{
	dir = 4
	},
/obj/machinery/atmospherics/pipe/smart/simple/supply/visible/layer4{
	dir = 8
	},
/obj/machinery/atmospherics/pipe/smart/simple/scrubbers/visible/layer2{
	dir = 4
	},
/obj/structure/cable,
/turf/open/floor/plating,
/area/tdome/arena)

(1,1,1) = {"
hB
GF
hB
hB
hp
hB
ZB
jB
"}
(2,1,1) = {"
Cz
YM
hB
Qw
Kc
hB
fX
sP
"}
(3,1,1) = {"
kS
Du
hB
XA
ex
hB
EK
Rw
"}
(4,1,1) = {"
hB
BI
hB
hB
Sz
hB
hB
lJ
"}
(5,1,1) = {"
DB
kD
Xf
sp
iP
Dp
YP
od
"}
(6,1,1) = {"
go
ZD
hB
hB
cC
hB
hB
zx
"}
(7,1,1) = {"
Dl
ZD
hB
QK
QP
oW
hB
zx
"}
(8,1,1) = {"
lB
VH
WK
Yq
nW
Gq
DE
tR
"}
(9,1,1) = {"
Dl
VH
hB
cz
aO
oW
hB
zx
"}
(10,1,1) = {"
xT
VH
hB
hB
iR
hB
hB
zx
"}
(11,1,1) = {"
eA
oJ
Xf
ot
fU
vk
hO
Um
"}
(12,1,1) = {"
hB
fq
hB
hB
BQ
hB
hB
yr
"}
(13,1,1) = {"
kS
dF
hB
XA
YM
hB
EK
nR
"}
(14,1,1) = {"
Cz
Sn
hB
Qw
vA
hB
Va
bP
"}
(15,1,1) = {"
hB
gL
hB
hB
GF
hB
ZB
Dx
"}
